xxxxxxxxxxxxxxxx
x  sss         x
x  xxx         x
x              x
x    p         x
x              x
xxxxsvvxxxvxvxvx
x      xfx     x
x      v v     x
x              x
x         p    x
xxxxxxxxxxxxxxxx
